33333333333333333
31111111111111113
31131111111111113
31131133333311113
11131111111311111
11131111131311111
11111111131313111
11133333131313111
31111111131113113
11133333131313111
11111111131313111
11131111131311111
11131111111311111
31131133333311113
31131111111111113
31111111111111113
33333333333333333
